%%%%%%%%%%%%%%%%%%%%
%        P. . %... %
%          %. %.%. %
%          %. %.%. %
%          %. %.%. %
%.         %....%. %
%%%%%%%%%%%%%%%%%%%%